30 36
####################################
#                  ###         #####
# #### ###########     #######     #
# #### #      S    ###     # # ### #
# P      #########     # # ### # # #
# ##### ###      ### ### # #P# # # #
# #   #   #        # ### # # # # # #
# #   # # #        # ### #   # # # #
# ##### # ########## ### ##### ### #
#             S                    #
# ####### ######## ##BBB## ## #### #
# ###  ## ######## ##BBB## ## #P## #
# #### ##    ##    ##BBB## ## # ## #
# ## #### ## ## ## ####### ## # ## #
# ##  ### ## ## ## ####### ##   ## #
# ##   ## ## ## ## ##   ## ####### #
# ####### ## ## ## ####### ####### #
#           S      .....     S     #
# ###### ### ########## ###### ### #
# #    # ### #####   #     S   # # #
# ######         ##### ### ### # # #
#    S   #######   S   # # # # # # #
# ###### #     ##### ### # # # ### #
# #    # ########### ##### ###     #
# ###### #     P      S      # ### #
#          ######### ####### # # # #
# ####### ########## #     #   # # #
# #######            ####### # ### #
#         ##########         #     #
####################################
